x,y
200,50
200,130
120,200
200,270
280,200
200,350
350,350
350,50
50,50
50,350
0,1,2,3,4,5,6,7,8,9
0,1,0,0,0,0,0,1,1,0
1,0,1,1,1,0,0,0,0,0
0,1,0,1,0,0,0,0,0,0
0,1,1,0,1,1,0,0,0,0
0,1,0,1,0,0,0,0,0,0
0,0,0,1,0,0,1,0,0,1
0,0,0,0,0,1,0,1,0,0
1,0,0,0,0,0,1,0,0,0
1,0,0,0,0,0,0,0,0,1
0,0,0,0,0,1,0,0,1,0